NO ./textures/chateau.xpm
SO ./textures/monmicurse.xpm
WE ./textures/monmipot.xpm
EA ./textures/monmirail.xpm

F 153,76,0
C 0, 102, 204

11111111
10101001
1000E001
10001001
10010001
10001011
10001011
11111111